transaction_id,transaction_date,transaction_time,total_price,is_expense,current_balance,employee_id,completed
0,9/23/2023,14:53,95.50,FALSE,95.50,1,FALSE
1,9/23/2023,11:20,31.20,FALSE,126.70,2,FALSE
2,9/23/2023,13:08,11.30,FALSE,138.00,5,FALSE
3,9/23/2023,11:08,21.00,FALSE,159.00,5,FALSE
4,9/23/2023,14:47,24.90,FALSE,183.90,2,FALSE
5,9/23/2023,14:32,256.00,FALSE,439.90,3,FALSE
6,9/23/2023,17:45,66.40,FALSE,506.30,0,FALSE
7,9/23/2023,10:25,323.40,FALSE,829.70,5,FALSE
8,9/23/2023,17:04,99.10,FALSE,928.80,1,FALSE
9,9/23/2023,14:31,90.00,FALSE,1018.80,1,FALSE
10,9/23/2023,12:53,422.40,FALSE,1441.20,0,FALSE
11,9/23/2023,10:59,-40.00,TRUE,1401.20,3,FALSE
12,9/23/2023,11:49,-25.25,TRUE,1375.95,4,FALSE
13,9/23/2023,16:44,12.80,FALSE,1388.75,3,FALSE
14,9/23/2023,12:26,12.80,FALSE,1401.55,4,FALSE
15,9/23/2023,12:39,5.20,FALSE,1406.75,0,FALSE
16,9/23/2023,13:42,53.20,FALSE,1459.95,2,FALSE
17,9/23/2023,09:19,30.90,FALSE,1490.85,1,FALSE
18,9/23/2023,10:56,38.40,FALSE,1529.25,4,FALSE
19,9/23/2023,12:45,821.70,FALSE,2350.95,1,FALSE
20,9/23/2023,15:05,713.80,FALSE,3064.75,4,FALSE
21,9/23/2023,10:42,456.50,FALSE,3521.25,1,FALSE
22,9/23/2023,14:50,547.80,FALSE,4069.05,0,FALSE
23,9/24/2023,17:03,655.70,FALSE,4724.75,5,FALSE
24,9/24/2023,16:32,780.20,FALSE,5504.95,5,FALSE
25,9/24/2023,13:59,722.10,FALSE,6227.05,5,FALSE
26,9/25/2023,17:10,722.10,FALSE,6949.15,4,FALSE
27,9/25/2023,12:03,547.80,FALSE,7496.95,1,FALSE
28,9/25/2023,12:52,431.60,FALSE,7928.55,5,FALSE
29,9/26/2023,16:46,755.30,FALSE,8683.85,5,FALSE
30,9/26/2023,14:49,531.20,FALSE,9215.05,1,FALSE
31,9/26/2023,12:28,763.60,FALSE,9978.65,0,FALSE
32,9/27/2023,14:06,664.00,FALSE,10642.65,5,FALSE
33,9/27/2023,09:13,539.50,FALSE,11182.15,3,FALSE
34,9/27/2023,15:09,423.30,FALSE,11605.45,0,FALSE
35,9/28/2023,12:07,506.30,FALSE,12111.75,0,FALSE
36,9/28/2023,11:23,730.40,FALSE,12842.15,1,FALSE
37,9/28/2023,09:54,431.60,FALSE,13273.75,4,FALSE
38,9/29/2023,10:13,639.10,FALSE,13912.85,3,FALSE
39,9/29/2023,17:15,464.80,FALSE,14377.65,1,FALSE
40,9/29/2023,13:11,556.10,FALSE,14933.75,1,FALSE
41,9/30/2023,13:37,771.90,FALSE,15705.65,0,FALSE
42,9/30/2023,10:52,423.30,FALSE,16128.95,4,FALSE
43,9/30/2023,12:02,597.60,FALSE,16726.55,2,FALSE
44,10/1/2023,13:43,448.20,FALSE,17174.75,4,FALSE
45,10/1/2023,13:43,796.80,FALSE,17971.55,0,FALSE
46,10/1/2023,16:44,639.10,FALSE,18610.65,1,FALSE
47,10/2/2023,11:28,672.30,FALSE,19282.95,3,FALSE
48,10/2/2023,11:51,564.40,FALSE,19847.35,5,FALSE
49,10/2/2023,09:57,747.00,FALSE,20594.35,4,FALSE
50,10/3/2023,16:48,680.60,FALSE,21274.95,3,FALSE
51,10/3/2023,10:14,456.50,FALSE,21731.45,0,FALSE
52,10/3/2023,12:24,605.90,FALSE,22337.35,3,FALSE
53,10/4/2023,13:04,672.30,FALSE,23009.65,0,FALSE
54,10/4/2023,12:05,805.10,FALSE,23814.75,0,FALSE
55,10/4/2023,14:56,755.30,FALSE,24570.05,5,FALSE
56,10/5/2023,14:25,581.00,FALSE,25151.05,4,FALSE
57,10/5/2023,14:03,456.50,FALSE,25607.55,2,FALSE
58,10/5/2023,14:22,498.00,FALSE,26105.55,2,FALSE
59,10/6/2023,09:17,755.30,FALSE,26860.85,5,FALSE
60,10/6/2023,16:25,821.70,FALSE,27682.55,3,FALSE
61,10/6/2023,13:50,522.90,FALSE,28205.45,3,FALSE
62,10/7/2023,11:39,439.90,FALSE,28645.35,0,FALSE
63,10/7/2023,09:17,647.40,FALSE,29292.75,0,FALSE
64,10/7/2023,11:18,646.80,FALSE,29939.55,2,FALSE
65,10/8/2023,12:33,646.80,FALSE,30586.35,3,FALSE
66,10/8/2023,12:26,823.20,FALSE,31409.55,2,FALSE
67,10/8/2023,10:26,793.80,FALSE,32203.35,0,FALSE
68,10/9/2023,10:22,568.40,FALSE,32771.75,4,FALSE
69,10/9/2023,13:55,852.60,FALSE,33624.35,0,FALSE
70,10/9/2023,15:39,862.40,FALSE,34486.75,2,FALSE
71,10/10/2023,09:01,656.60,FALSE,35143.35,2,FALSE
72,10/10/2023,11:28,833.00,FALSE,35976.35,2,FALSE
73,10/10/2023,11:51,862.40,FALSE,36838.75,4,FALSE
74,10/11/2023,14:55,715.40,FALSE,37554.15,5,FALSE
75,10/11/2023,14:53,803.60,FALSE,38357.75,2,FALSE
76,10/11/2023,15:06,637.00,FALSE,38994.75,2,FALSE
77,10/12/2023,11:04,980.00,FALSE,39974.75,5,FALSE
78,10/12/2023,12:01,499.80,FALSE,40474.55,4,FALSE
79,10/12/2023,11:43,744.80,FALSE,41219.35,4,FALSE
80,10/13/2023,10:04,793.80,FALSE,42013.15,5,FALSE
81,10/13/2023,10:08,632.80,FALSE,42645.95,5,FALSE
82,10/13/2023,10:43,597.80,FALSE,43243.75,4,FALSE
83,10/14/2023,16:01,901.60,FALSE,44145.35,1,FALSE
84,10/14/2023,16:57,617.40,FALSE,44762.75,3,FALSE
85,10/14/2023,14:13,637.00,FALSE,45399.75,5,FALSE
86,10/15/2023,13:44,950.60,FALSE,46350.35,0,FALSE
87,10/15/2023,10:38,891.80,FALSE,47242.15,4,FALSE
88,10/15/2023,10:30,847.50,FALSE,48089.65,3,FALSE
89,10/16/2023,13:03,666.70,FALSE,48756.35,4,FALSE
90,10/16/2023,10:56,734.50,FALSE,49490.85,5,FALSE
91,10/16/2023,13:15,1254.40,FALSE,50745.25,5,FALSE
92,10/17/2023,11:25,711.90,FALSE,51457.15,5,FALSE
93,10/17/2023,17:31,896.40,FALSE,52353.55,1,FALSE
94,10/17/2023,12:35,1587.30,FALSE,53940.85,3,FALSE
95,10/18/2023,11:27,1273.50,FALSE,55214.35,3,FALSE
96,10/18/2023,14:45,1445.40,FALSE,56659.75,1,FALSE
97,10/18/2023,17:23,1502.60,FALSE,58162.35,0,FALSE
98,10/19/2023,16:31,1150.00,FALSE,59312.35,3,FALSE
99,10/19/2023,17:55,836.20,FALSE,60148.55,2,FALSE
100,10/19/2023,14:10,1062.40,FALSE,61210.95,4,FALSE
101,10/20/2023,16:14,1096.10,FALSE,62307.05,4,FALSE
102,10/20/2023,13:14,678.00,FALSE,62985.05,4,FALSE
103,10/20/2023,15:43,1203.20,FALSE,64188.25,5,FALSE
104,10/21/2023,15:59,1190.40,FALSE,65378.65,1,FALSE
105,10/21/2023,16:14,1050.90,FALSE,66429.55,0,FALSE
106,10/21/2023,09:08,836.20,FALSE,67265.75,3,FALSE
107,10/22/2023,14:18,986.20,FALSE,68251.95,5,FALSE
108,10/22/2023,10:13,1208.00,FALSE,69459.95,2,FALSE
109,10/22/2023,10:09,689.60,FALSE,70149.55,5,FALSE
110,10/23/2023,15:50,999.40,FALSE,71148.95,3,FALSE
111,10/23/2023,16:31,1059.10,FALSE,72208.05,5,FALSE
112,10/23/2023,10:53,930.90,FALSE,73138.95,3,FALSE
113,10/24/2023,17:12,911.90,FALSE,74050.85,2,FALSE
114,10/24/2023,15:02,841.40,FALSE,74892.25,0,FALSE
115,10/24/2023,13:14,816.10,FALSE,75708.35,0,FALSE
116,10/25/2023,14:03,870.10,FALSE,76578.45,2,FALSE
117,10/25/2023,15:03,779.70,FALSE,77358.15,0,FALSE
118,10/25/2023,16:31,881.40,FALSE,78239.55,5,FALSE
119,10/26/2023,09:15,1216.00,FALSE,79455.55,1,FALSE
120,10/26/2023,15:40,757.10,FALSE,80212.65,2,FALSE
121,10/26/2023,14:24,1062.20,FALSE,81274.85,0,FALSE
122,10/27/2023,14:48,1062.20,FALSE,82337.05,3,FALSE
123,10/27/2023,12:22,757.10,FALSE,83094.15,0,FALSE
124,10/27/2023,09:03,578.20,FALSE,83672.35,4,FALSE
125,10/28/2023,14:41,597.80,FALSE,84270.15,2,FALSE
126,10/28/2023,15:41,627.20,FALSE,84897.35,5,FALSE
127,10/28/2023,13:38,568.40,FALSE,85465.75,2,FALSE
128,10/29/2023,09:14,711.90,FALSE,86177.65,4,FALSE
129,10/29/2023,09:53,744.80,FALSE,86922.45,3,FALSE
130,10/29/2023,14:34,578.20,FALSE,87500.65,4,FALSE
131,10/30/2023,14:01,1118.70,FALSE,88619.35,3,FALSE
132,10/30/2023,15:12,852.60,FALSE,89471.95,3,FALSE
133,10/30/2023,13:00,735.00,FALSE,90206.95,0,FALSE
134,10/31/2023,17:36,519.40,FALSE,90726.35,3,FALSE
135,10/31/2023,15:05,655.40,FALSE,91381.75,3,FALSE
136,10/31/2023,16:53,970.20,FALSE,92351.95,4,FALSE
137,11/1/2023,11:16,678.00,FALSE,93029.95,3,FALSE
138,11/1/2023,10:59,823.20,FALSE,93853.15,4,FALSE
139,11/1/2023,09:43,1017.00,FALSE,94870.15,2,FALSE
140,11/2/2023,13:10,911.40,FALSE,95781.55,1,FALSE
141,11/2/2023,15:50,764.40,FALSE,96545.95,0,FALSE
142,11/2/2023,16:10,872.20,FALSE,97418.15,4,FALSE
143,11/3/2023,15:23,1100.80,FALSE,98518.95,3,FALSE
144,11/3/2023,10:13,904.00,FALSE,99422.95,2,FALSE
145,11/3/2023,15:49,844.80,FALSE,100267.75,4,FALSE
146,11/4/2023,17:08,1073.50,FALSE,101341.25,3,FALSE
147,11/4/2023,14:24,477.90,FALSE,101819.15,5,FALSE
148,11/4/2023,14:08,1168.30,FALSE,102987.45,5,FALSE
149,11/5/2023,16:00,1459.20,FALSE,104446.65,2,FALSE
150,11/5/2023,17:27,1272.70,FALSE,105719.35,1,FALSE
151,11/5/2023,15:16,1271.80,FALSE,106991.15,5,FALSE
152,11/6/2023,12:31,1669.20,FALSE,108660.35,1,FALSE
153,11/6/2023,11:25,711.90,FALSE,109372.25,2,FALSE
154,11/6/2023,11:55,1073.50,FALSE,110445.75,1,FALSE
155,11/7/2023,09:53,621.50,FALSE,111067.25,4,FALSE
156,11/7/2023,17:09,1028.30,FALSE,112095.55,0,FALSE
157,11/7/2023,13:44,691.20,FALSE,112786.75,1,FALSE
158,11/8/2023,17:32,587.60,FALSE,113374.35,2,FALSE
159,11/8/2023,15:07,587.60,FALSE,113961.95,0,FALSE
160,11/8/2023,17:31,644.10,FALSE,114606.05,1,FALSE
161,11/9/2023,09:04,644.10,FALSE,115250.15,1,FALSE
162,11/9/2023,11:49,659.50,FALSE,115909.65,4,FALSE
163,11/9/2023,11:19,809.40,FALSE,116719.05,3,FALSE
164,11/10/2023,12:33,815.50,FALSE,117534.55,1,FALSE
165,11/10/2023,15:59,707.70,FALSE,118242.25,1,FALSE
166,11/10/2023,17:57,859.00,FALSE,119101.25,5,FALSE
167,11/11/2023,13:58,1083.40,FALSE,120184.65,3,FALSE
168,11/11/2023,16:17,1315.10,FALSE,121499.75,0,FALSE
169,11/11/2023,15:46,914.90,FALSE,122414.65,5,FALSE
170,11/12/2023,15:11,858.00,FALSE,123272.65,2,FALSE
171,11/12/2023,12:34,576.30,FALSE,123848.95,0,FALSE
172,11/12/2023,12:05,704.00,FALSE,124552.95,1,FALSE
173,11/13/2023,14:40,1107.40,FALSE,125660.35,3,FALSE
174,11/13/2023,10:14,757.90,FALSE,126418.25,3,FALSE
175,11/13/2023,16:43,844.80,FALSE,127263.05,5,FALSE
176,11/14/2023,15:01,745.80,FALSE,128008.85,4,FALSE
177,11/14/2023,11:56,587.60,FALSE,128596.45,5,FALSE
178,11/14/2023,13:01,676.20,FALSE,129272.65,1,FALSE
179,11/15/2023,10:42,891.80,FALSE,130164.45,3,FALSE
180,11/15/2023,16:26,833.00,FALSE,130997.45,4,FALSE
181,11/15/2023,09:13,784.00,FALSE,131781.45,4,FALSE
182,11/16/2023,17:02,715.40,FALSE,132496.85,3,FALSE
183,11/16/2023,16:01,1130.00,FALSE,133626.85,3,FALSE
184,11/16/2023,09:31,705.60,FALSE,134332.45,2,FALSE
185,11/17/2023,09:01,695.80,FALSE,135028.25,2,FALSE
186,11/17/2023,10:18,568.40,FALSE,135596.65,4,FALSE
187,11/17/2023,14:19,509.60,FALSE,136106.25,5,FALSE
188,11/18/2023,13:31,970.20,FALSE,137076.45,2,FALSE
189,11/18/2023,14:58,695.80,FALSE,137772.25,0,FALSE
190,11/18/2023,17:17,852.60,FALSE,138624.85,1,FALSE
191,11/19/2023,17:16,597.80,FALSE,139222.65,0,FALSE
192,11/19/2023,10:52,597.80,FALSE,139820.45,1,FALSE
193,11/19/2023,12:29,774.20,FALSE,140594.65,5,FALSE
194,11/20/2023,13:15,539.00,FALSE,141133.65,1,FALSE
195,11/20/2023,14:54,774.20,FALSE,141907.85,3,FALSE
196,11/20/2023,12:54,499.80,FALSE,142407.65,0,FALSE
197,11/21/2023,09:54,640.00,FALSE,143047.65,0,FALSE
198,11/21/2023,09:29,711.90,FALSE,143759.55,2,FALSE
199,11/21/2023,14:51,819.20,FALSE,144578.75,2,FALSE
200,11/22/2023,11:31,949.20,FALSE,145527.95,2,FALSE
201,11/22/2023,15:33,495.00,FALSE,146022.95,3,FALSE
202,11/22/2023,11:55,1269.90,FALSE,147292.85,0,FALSE
203,11/23/2023,10:50,1407.20,FALSE,148700.05,2,FALSE
204,11/23/2023,15:40,1693.40,FALSE,150393.45,5,FALSE
205,11/23/2023,09:20,1446.50,FALSE,151839.95,0,FALSE
206,11/24/2023,09:32,1213.60,FALSE,153053.55,2,FALSE
207,11/24/2023,10:19,700.60,FALSE,153754.15,2,FALSE
208,11/24/2023,17:54,1049.60,FALSE,154803.75,0,FALSE
209,11/25/2023,15:38,1039.60,FALSE,155843.35,1,FALSE
210,11/25/2023,17:06,587.60,FALSE,156430.95,1,FALSE
211,11/25/2023,13:46,678.00,FALSE,157108.95,5,FALSE
212,11/26/2023,11:03,1073.50,FALSE,158182.45,5,FALSE
213,11/26/2023,09:15,1177.00,FALSE,159359.45,2,FALSE
214,11/26/2023,15:54,844.80,FALSE,160204.25,4,FALSE
215,11/27/2023,12:18,822.30,FALSE,161026.55,4,FALSE
216,11/27/2023,16:15,771.30,FALSE,161797.85,2,FALSE
217,11/27/2023,11:52,830.50,FALSE,162628.35,4,FALSE
218,11/28/2023,14:28,847.70,FALSE,163476.05,5,FALSE
219,11/28/2023,14:05,1038.40,FALSE,164514.45,4,FALSE
220,11/28/2023,11:39,851.60,FALSE,165366.05,2,FALSE
221,11/29/2023,10:11,848.40,FALSE,166214.45,4,FALSE
222,11/29/2023,13:33,1133.30,FALSE,167347.75,4,FALSE
223,11/29/2023,14:17,887.00,FALSE,168234.75,4,FALSE
224,11/30/2023,11:03,819.20,FALSE,169053.95,0,FALSE
225,11/30/2023,16:31,972.80,FALSE,170026.75,3,FALSE
226,11/30/2023,16:29,689.30,FALSE,170716.05,3,FALSE
227,12/1/2023,11:03,655.40,FALSE,171371.45,3,FALSE
228,12/1/2023,15:39,565.00,FALSE,171936.45,4,FALSE
229,12/1/2023,11:14,565.00,FALSE,172501.45,0,FALSE
230,12/2/2023,09:11,565.00,FALSE,173066.45,0,FALSE
231,12/2/2023,11:37,1017.00,FALSE,174083.45,3,FALSE
232,12/2/2023,16:35,627.20,FALSE,174710.65,4,FALSE
233,12/3/2023,15:52,1039.60,FALSE,175750.25,1,FALSE
234,12/3/2023,16:23,931.00,FALSE,176681.25,2,FALSE
235,12/3/2023,16:54,588.00,FALSE,177269.25,1,FALSE
236,12/4/2023,11:53,970.20,FALSE,178239.45,3,FALSE
237,12/4/2023,10:26,607.60,FALSE,178847.05,4,FALSE
238,12/4/2023,11:03,824.90,FALSE,179671.95,0,FALSE
239,12/5/2023,13:18,529.20,FALSE,180201.15,4,FALSE
240,12/5/2023,10:16,578.20,FALSE,180779.35,2,FALSE
241,12/5/2023,17:22,519.40,FALSE,181298.75,3,FALSE
242,12/6/2023,11:12,735.00,FALSE,182033.75,2,FALSE
243,12/6/2023,09:23,872.20,FALSE,182905.95,1,FALSE
244,12/6/2023,10:22,904.00,FALSE,183809.95,2,FALSE
245,12/7/2023,13:40,842.80,FALSE,184652.75,4,FALSE
246,12/7/2023,13:33,1084.80,FALSE,185737.55,2,FALSE
247,12/7/2023,15:23,745.80,FALSE,186483.35,5,FALSE
248,12/8/2023,12:01,921.20,FALSE,187404.55,4,FALSE
249,12/8/2023,14:36,632.80,FALSE,188037.35,0,FALSE
250,12/8/2023,10:55,588.00,FALSE,188625.35,0,FALSE
251,12/9/2023,17:30,847.50,FALSE,189472.85,5,FALSE
252,12/9/2023,11:30,836.20,FALSE,190309.05,1,FALSE
253,12/9/2023,11:28,983.10,FALSE,191292.15,5,FALSE
254,12/10/2023,13:02,944.10,FALSE,192236.25,0,FALSE
255,12/10/2023,13:13,627.00,FALSE,192863.25,3,FALSE
256,12/10/2023,14:25,1834.90,FALSE,194698.15,1,FALSE
257,12/11/2023,11:36,1925.20,FALSE,196623.35,0,FALSE
258,12/11/2023,15:53,1787.90,FALSE,198411.25,2,FALSE
259,12/11/2023,12:27,1662.80,FALSE,200074.05,3,FALSE
260,12/12/2023,09:24,1483.00,FALSE,201557.05,0,FALSE
261,12/12/2023,11:56,1096.10,FALSE,202653.15,4,FALSE
262,12/12/2023,10:41,1024.00,FALSE,203677.15,4,FALSE
263,12/13/2023,14:40,576.30,FALSE,204253.45,0,FALSE
264,12/13/2023,13:49,1096.10,FALSE,205349.55,5,FALSE
265,12/13/2023,14:41,896.00,FALSE,206245.55,0,FALSE
266,12/14/2023,10:24,1028.30,FALSE,207273.85,1,FALSE
267,12/14/2023,09:32,1028.30,FALSE,208302.15,5,FALSE
268,12/14/2023,09:57,847.50,FALSE,209149.65,2,FALSE
269,12/15/2023,12:21,847.50,FALSE,209997.15,5,FALSE
270,12/15/2023,15:43,1350.90,FALSE,211348.05,5,FALSE
271,12/15/2023,10:08,1337.00,FALSE,212685.05,2,FALSE
272,12/16/2023,15:33,871.20,FALSE,213556.25,2,FALSE
273,12/16/2023,11:30,810.80,FALSE,214367.05,4,FALSE
274,12/16/2023,12:55,1045.80,FALSE,215412.85,5,FALSE
275,12/17/2023,12:50,1061.10,FALSE,216473.95,2,FALSE
276,12/17/2023,10:24,722.60,FALSE,217196.55,3,FALSE
277,12/17/2023,11:07,1143.00,FALSE,218339.55,1,FALSE
278,12/18/2023,09:30,949.20,FALSE,219288.75,3,FALSE
279,12/18/2023,10:04,1139.20,FALSE,220427.95,0,FALSE
280,12/18/2023,15:42,1050.90,FALSE,221478.85,0,FALSE
281,12/19/2023,12:25,1118.70,FALSE,222597.55,0,FALSE
282,12/19/2023,10:04,802.30,FALSE,223399.85,0,FALSE
283,12/19/2023,13:58,1096.10,FALSE,224495.95,0,FALSE
284,12/20/2023,15:38,1184.60,FALSE,225680.55,4,FALSE
285,12/20/2023,10:18,768.40,FALSE,226448.95,3,FALSE
286,12/20/2023,13:55,744.80,FALSE,227193.75,2,FALSE
287,12/21/2023,11:04,926.60,FALSE,228120.35,1,FALSE
288,12/21/2023,17:19,940.80,FALSE,229061.15,4,FALSE
289,12/21/2023,15:59,784.00,FALSE,229845.15,1,FALSE
290,12/22/2023,09:03,1011.20,FALSE,230856.35,5,FALSE
291,12/22/2023,15:13,1073.50,FALSE,231929.85,2,FALSE
292,12/22/2023,15:38,490.00,FALSE,232419.85,0,FALSE
293,12/23/2023,15:42,617.40,FALSE,233037.25,3,FALSE
294,12/23/2023,13:23,960.50,FALSE,233997.75,4,FALSE
295,12/23/2023,15:05,655.40,FALSE,234653.15,1,FALSE
296,12/24/2023,15:54,1028.30,FALSE,235681.45,5,FALSE
297,12/24/2023,14:24,960.50,FALSE,236641.95,3,FALSE
298,12/24/2023,12:30,980.00,FALSE,237621.95,3,FALSE
299,12/25/2023,13:23,1050.90,FALSE,238672.85,5,FALSE
300,12/25/2023,12:37,656.60,FALSE,239329.45,5,FALSE
301,12/25/2023,16:30,852.60,FALSE,240182.05,2,FALSE
302,12/26/2023,13:16,607.60,FALSE,240789.65,4,FALSE
303,12/26/2023,12:03,617.40,FALSE,241407.05,4,FALSE
304,12/26/2023,16:40,911.40,FALSE,242318.45,0,FALSE
305,12/27/2023,13:05,1118.70,FALSE,243437.15,3,FALSE
306,12/27/2023,11:00,700.60,FALSE,244137.75,4,FALSE
307,12/27/2023,09:03,621.50,FALSE,244759.25,0,FALSE
308,12/28/2023,17:45,1050.90,FALSE,245810.15,1,FALSE
309,12/28/2023,09:42,535.50,FALSE,246345.65,4,FALSE
310,12/28/2023,15:32,1188.30,FALSE,247533.95,1,FALSE
311,12/29/2023,10:09,1198.30,FALSE,248732.25,2,FALSE
312,12/29/2023,13:48,1483.20,FALSE,250215.45,5,FALSE
313,12/29/2023,13:54,1639.20,FALSE,251854.65,3,FALSE
314,12/30/2023,09:21,1617.60,FALSE,253472.25,3,FALSE
315,12/30/2023,09:24,1130.00,FALSE,254602.25,5,FALSE
316,12/30/2023,11:33,632.80,FALSE,255235.05,5,FALSE
317,12/31/2023,10:56,983.10,FALSE,256218.15,5,FALSE
318,12/31/2023,09:55,1028.30,FALSE,257246.45,3,FALSE
319,12/31/2023,10:25,1005.70,FALSE,258252.15,1,FALSE
320,1/1/2024,16:42,598.90,FALSE,258851.05,5,FALSE
321,1/1/2024,12:29,598.90,FALSE,259449.95,2,FALSE
322,1/1/2024,14:28,1005.70,FALSE,260455.65,2,FALSE
323,1/2/2024,12:36,1005.70,FALSE,261461.35,4,FALSE
324,1/2/2024,17:35,1106.40,FALSE,262567.75,2,FALSE
325,1/2/2024,13:21,931.50,FALSE,263499.25,2,FALSE
326,1/3/2024,09:03,719.80,FALSE,264219.05,2,FALSE
327,1/3/2024,14:17,802.40,FALSE,265021.45,3,FALSE
328,1/3/2024,12:59,1237.90,FALSE,266259.35,2,FALSE
329,1/4/2024,17:46,1104.60,FALSE,267363.95,5,FALSE
330,1/4/2024,15:02,1041.30,FALSE,268405.25,2,FALSE
331,1/4/2024,09:22,1091.70,FALSE,269496.95,0,FALSE
332,1/5/2024,17:36,1358.50,FALSE,270855.45,1,FALSE
333,1/5/2024,11:48,610.20,FALSE,271465.65,4,FALSE
334,1/5/2024,14:08,960.50,FALSE,272426.15,3,FALSE
335,1/6/2024,10:36,881.40,FALSE,273307.55,3,FALSE
336,1/6/2024,11:51,1011.20,FALSE,274318.75,1,FALSE
337,1/6/2024,13:45,691.20,FALSE,275009.95,0,FALSE
338,1/7/2024,11:19,610.20,FALSE,275620.15,0,FALSE
339,1/7/2024,12:29,915.30,FALSE,276535.45,5,FALSE
340,1/7/2024,15:35,980.00,FALSE,277515.45,4,FALSE
341,1/8/2024,13:21,1186.90,FALSE,278702.35,1,FALSE
342,1/8/2024,16:14,498.00,FALSE,279200.35,5,FALSE
343,1/8/2024,17:07,588.00,FALSE,279788.35,0,FALSE
344,1/9/2024,16:48,788.50,FALSE,280576.85,0,FALSE
345,1/9/2024,11:02,686.00,FALSE,281262.85,1,FALSE
346,1/9/2024,12:27,1278.20,FALSE,282541.05,0,FALSE
347,1/10/2024,10:00,763.10,FALSE,283304.15,2,FALSE
348,1/10/2024,10:22,539.50,FALSE,283843.65,0,FALSE
349,1/10/2024,11:53,581.00,FALSE,284424.65,0,FALSE
350,1/11/2024,14:18,656.60,FALSE,285081.25,2,FALSE
351,1/11/2024,10:02,1128.80,FALSE,286210.05,1,FALSE
352,1/11/2024,13:05,769.00,FALSE,286979.05,5,FALSE
353,1/12/2024,13:39,572.70,FALSE,287551.75,4,FALSE
354,1/12/2024,10:19,473.10,FALSE,288024.85,2,FALSE
355,1/12/2024,10:38,747.00,FALSE,288771.85,3,FALSE
356,1/13/2024,17:24,1419.30,FALSE,290191.15,1,FALSE
357,1/13/2024,14:27,622.50,FALSE,290813.65,1,FALSE
358,1/13/2024,15:23,676.20,FALSE,291489.85,2,FALSE
359,1/14/2024,10:44,630.80,FALSE,292120.65,5,FALSE
360,1/14/2024,12:15,927.40,FALSE,293048.05,1,FALSE
361,1/14/2024,17:07,1361.20,FALSE,294409.25,4,FALSE
362,1/15/2024,13:44,439.90,FALSE,294849.15,5,FALSE
363,1/15/2024,09:36,713.80,FALSE,295562.95,1,FALSE
364,1/15/2024,12:17,922.80,FALSE,296485.75,0,FALSE
365,1/16/2024,11:25,622.50,FALSE,297108.25,2,FALSE
366,1/16/2024,11:47,1344.60,FALSE,298452.85,4,FALSE
367,1/16/2024,14:34,581.00,FALSE,299033.85,1,FALSE
368,1/17/2024,09:38,639.10,FALSE,299672.95,1,FALSE
369,1/17/2024,12:03,655.70,FALSE,300328.65,0,FALSE
370,1/17/2024,12:45,780.20,FALSE,301108.85,0,FALSE
371,1/18/2024,11:47,1347.70,FALSE,302456.55,3,FALSE
372,1/18/2024,12:57,809.70,FALSE,303266.25,0,FALSE
373,1/18/2024,09:44,665.00,FALSE,303931.25,0,FALSE
374,1/19/2024,12:55,605.90,FALSE,304537.15,3,FALSE
375,1/19/2024,16:58,598.90,FALSE,305136.05,0,FALSE
376,1/19/2024,09:41,576.30,FALSE,305712.35,5,FALSE
377,1/20/2024,14:35,1049.60,FALSE,306761.95,2,FALSE
378,1/20/2024,15:02,734.50,FALSE,307496.45,5,FALSE
379,1/20/2024,17:04,704.70,FALSE,308201.15,2,FALSE
380,1/21/2024,15:35,1451.70,FALSE,309652.85,3,FALSE
381,1/21/2024,16:55,1486.30,FALSE,311139.15,4,FALSE
382,1/21/2024,14:18,1017.00,FALSE,312156.15,5,FALSE
383,1/22/2024,15:56,2369.40,FALSE,314525.55,3,FALSE
384,1/22/2024,15:38,881.40,FALSE,315406.95,4,FALSE
385,1/22/2024,12:07,1264.80,FALSE,316671.75,2,FALSE
386,1/23/2024,10:44,836.20,FALSE,317507.95,0,FALSE
387,1/23/2024,10:11,937.90,FALSE,318445.85,4,FALSE
388,1/23/2024,14:41,949.20,FALSE,319395.05,4,FALSE
389,1/24/2024,09:13,621.50,FALSE,320016.55,3,FALSE
390,1/24/2024,13:01,960.50,FALSE,320977.05,1,FALSE
391,1/24/2024,16:05,1088.00,FALSE,322065.05,2,FALSE
392,1/25/2024,16:33,881.40,FALSE,322946.45,3,FALSE
393,1/25/2024,12:42,881.40,FALSE,323827.85,4,FALSE
394,1/25/2024,12:21,806.60,FALSE,324634.45,5,FALSE
395,1/26/2024,17:26,1188.20,FALSE,325822.65,3,FALSE
396,1/26/2024,15:51,1228.20,FALSE,327050.85,0,FALSE
397,1/26/2024,10:38,1314.90,FALSE,328365.75,3,FALSE
398,1/27/2024,10:08,1023.40,FALSE,329389.15,1,FALSE
399,1/27/2024,16:57,644.10,FALSE,330033.25,2,FALSE
400,1/27/2024,17:11,1101.20,FALSE,331134.45,5,FALSE
401,1/28/2024,09:53,768.00,FALSE,331902.45,4,FALSE
402,1/28/2024,12:30,1036.80,FALSE,332939.25,3,FALSE
403,1/28/2024,16:03,665.60,FALSE,333604.85,0,FALSE
404,1/29/2024,15:21,934.40,FALSE,334539.25,3,FALSE
405,1/29/2024,14:11,1172.60,FALSE,335711.85,2,FALSE
406,1/29/2024,15:34,1203.20,FALSE,336915.05,2,FALSE
407,1/30/2024,15:28,1118.70,FALSE,338033.75,5,FALSE
408,1/30/2024,12:54,1118.70,FALSE,339152.45,3,FALSE
409,1/30/2024,10:32,1228.80,FALSE,340381.25,5,FALSE
410,1/31/2024,10:28,637.00,FALSE,341018.25,5,FALSE
411,1/31/2024,15:17,734.50,FALSE,341752.75,3,FALSE
412,1/31/2024,12:16,607.60,FALSE,342360.35,3,FALSE
413,2/1/2024,11:56,597.80,FALSE,342958.15,5,FALSE
414,2/1/2024,17:47,983.10,FALSE,343941.25,1,FALSE
415,2/1/2024,09:32,735.00,FALSE,344676.25,0,FALSE
416,2/2/2024,13:32,931.00,FALSE,345607.25,0,FALSE
417,2/2/2024,14:16,931.00,FALSE,346538.25,5,FALSE
418,2/2/2024,09:11,891.80,FALSE,347430.05,1,FALSE
419,2/3/2024,09:10,627.20,FALSE,348057.25,1,FALSE
420,2/3/2024,14:00,1039.60,FALSE,349096.85,1,FALSE
421,2/3/2024,13:43,597.80,FALSE,349694.65,0,FALSE
422,2/4/2024,10:38,823.20,FALSE,350517.85,0,FALSE
423,2/4/2024,10:19,656.60,FALSE,351174.45,4,FALSE
424,2/4/2024,14:18,548.80,FALSE,351723.25,1,FALSE
425,2/5/2024,15:31,610.20,FALSE,352333.45,4,FALSE
426,2/5/2024,11:44,904.00,FALSE,353237.45,2,FALSE
427,2/5/2024,16:45,695.80,FALSE,353933.25,1,FALSE
428,2/6/2024,15:21,813.40,FALSE,354746.65,5,FALSE
429,2/6/2024,10:09,704.00,FALSE,355450.65,0,FALSE
430,2/6/2024,17:26,983.10,FALSE,356433.75,1,FALSE
431,2/7/2024,09:29,881.40,FALSE,357315.15,2,FALSE
432,2/7/2024,12:40,1073.50,FALSE,358388.65,3,FALSE
433,2/7/2024,11:18,607.20,FALSE,358995.85,4,FALSE
434,2/8/2024,13:42,1619.80,FALSE,360615.65,0,FALSE
435,2/8/2024,13:12,1479.10,FALSE,362094.75,2,FALSE
436,2/8/2024,15:27,1073.50,FALSE,363168.25,0,FALSE
437,2/9/2024,17:02,1624.90,FALSE,364793.15,0,FALSE
438,2/9/2024,10:14,926.60,FALSE,365719.75,4,FALSE
439,2/9/2024,12:31,1757.70,FALSE,367477.45,3,FALSE
440,2/10/2024,10:13,768.40,FALSE,368245.85,0,FALSE
441,2/10/2024,09:00,1113.60,FALSE,369359.45,0,FALSE
442,2/10/2024,16:04,870.10,FALSE,370229.55,0,FALSE
443,2/11/2024,17:11,689.30,FALSE,370918.85,1,FALSE
444,2/11/2024,12:22,779.70,FALSE,371698.55,5,FALSE
445,2/11/2024,16:31,907.20,FALSE,372605.75,5,FALSE
446,2/12/2024,12:01,824.90,FALSE,373430.65,3,FALSE
447,2/12/2024,17:13,824.90,FALSE,374255.55,1,FALSE
448,2/12/2024,12:44,671.50,FALSE,374927.05,4,FALSE
449,2/13/2024,13:01,1007.80,FALSE,375934.85,3,FALSE
450,2/13/2024,14:07,861.30,FALSE,376796.15,3,FALSE
451,2/13/2024,16:09,982.60,FALSE,377778.75,1,FALSE
452,2/14/2024,16:56,1092.00,FALSE,378870.75,5,FALSE
453,2/14/2024,09:08,994.40,FALSE,379865.15,5,FALSE
454,2/14/2024,13:33,1146.20,FALSE,381011.35,4,FALSE
455,2/15/2024,16:27,1152.00,FALSE,382163.35,2,FALSE
456,2/15/2024,16:50,1086.80,FALSE,383250.15,4,FALSE
457,2/15/2024,16:04,1203.20,FALSE,384453.35,5,FALSE
458,2/16/2024,09:54,1096.10,FALSE,385549.45,5,FALSE
459,2/16/2024,17:36,836.20,FALSE,386385.65,5,FALSE
460,2/16/2024,12:17,1228.80,FALSE,387614.45,3,FALSE
461,2/17/2024,14:32,857.60,FALSE,388472.05,5,FALSE
462,2/17/2024,15:04,757.10,FALSE,389229.15,5,FALSE
463,2/17/2024,17:07,851.10,FALSE,390080.25,1,FALSE
464,2/18/2024,10:12,960.40,FALSE,391040.65,0,FALSE
465,2/18/2024,14:25,656.60,FALSE,391697.25,1,FALSE
466,2/18/2024,17:07,578.20,FALSE,392275.45,3,FALSE
467,2/19/2024,11:34,610.20,FALSE,392885.65,3,FALSE
468,2/19/2024,13:16,862.40,FALSE,393748.05,3,FALSE
469,2/19/2024,14:06,627.20,FALSE,394375.25,2,FALSE
470,2/20/2024,09:34,490.00,FALSE,394865.25,5,FALSE
471,2/20/2024,14:53,1073.50,FALSE,395938.75,5,FALSE
472,2/20/2024,14:19,754.60,FALSE,396693.35,5,FALSE
473,2/21/2024,14:15,587.60,FALSE,397280.95,2,FALSE
474,2/21/2024,11:16,774.20,FALSE,398055.15,5,FALSE
475,2/21/2024,10:45,558.60,FALSE,398613.75,3,FALSE
476,2/22/2024,12:23,607.60,FALSE,399221.35,3,FALSE
477,2/22/2024,11:22,754.60,FALSE,399975.95,1,FALSE
478,2/22/2024,14:55,862.40,FALSE,400838.35,0,FALSE
479,2/23/2024,10:57,725.20,FALSE,401563.55,4,FALSE
480,2/23/2024,11:44,960.40,FALSE,402523.95,3,FALSE
481,2/23/2024,17:01,960.40,FALSE,403484.35,5,FALSE
482,2/24/2024,14:53,578.20,FALSE,404062.55,0,FALSE
483,2/24/2024,11:58,587.60,FALSE,404650.15,2,FALSE
484,2/24/2024,16:12,832.00,FALSE,405482.15,5,FALSE
485,2/25/2024,09:37,598.90,FALSE,406081.05,3,FALSE
486,2/25/2024,12:12,598.90,FALSE,406679.95,2,FALSE
487,2/25/2024,15:09,376.20,FALSE,407056.15,1,FALSE
488,2/26/2024,16:43,1198.50,FALSE,408254.65,2,FALSE
489,2/26/2024,09:39,1595.20,FALSE,409849.85,0,FALSE
490,2/26/2024,13:40,960.50,FALSE,410810.35,1,FALSE
491,2/27/2024,13:57,1911.30,FALSE,412721.65,2,FALSE
492,2/27/2024,17:21,678.00,FALSE,413399.65,5,FALSE
493,2/27/2024,14:51,1323.00,FALSE,414722.65,2,FALSE
494,2/28/2024,09:59,847.50,FALSE,415570.15,0,FALSE
495,2/28/2024,17:53,870.10,FALSE,416440.25,1,FALSE
496,2/28/2024,09:44,665.60,FALSE,417105.85,0,FALSE
497,2/29/2024,14:43,892.70,FALSE,417998.55,0,FALSE
498,2/29/2024,15:11,847.50,FALSE,418846.05,3,FALSE
499,2/29/2024,11:49,847.50,FALSE,419693.55,5,FALSE
500,3/1/2024,11:19,734.50,FALSE,420428.05,4,FALSE
501,3/1/2024,12:28,734.50,FALSE,421162.55,3,FALSE
502,3/1/2024,15:37,1021.80,FALSE,422184.35,1,FALSE
503,3/2/2024,15:00,916.30,FALSE,423100.65,3,FALSE
504,3/2/2024,17:09,1080.80,FALSE,424181.45,5,FALSE
505,3/2/2024,14:58,918.60,FALSE,425100.05,3,FALSE
506,3/3/2024,13:21,1004.00,FALSE,426104.05,1,FALSE
507,3/3/2024,17:30,1029.60,FALSE,427133.65,1,FALSE
508,3/3/2024,16:08,1223.70,FALSE,428357.35,4,FALSE
509,3/4/2024,12:14,1267.20,FALSE,429624.55,3,FALSE
510,3/4/2024,11:21,844.80,FALSE,430469.35,1,FALSE
511,3/4/2024,09:24,1050.90,FALSE,431520.25,2,FALSE
512,3/5/2024,15:46,870.10,FALSE,432390.35,5,FALSE
513,3/5/2024,09:59,655.40,FALSE,433045.75,5,FALSE
514,3/5/2024,12:50,576.30,FALSE,433622.05,2,FALSE
515,3/6/2024,12:53,1005.70,FALSE,434627.75,3,FALSE
516,3/6/2024,10:03,1130.20,FALSE,435757.95,5,FALSE
517,3/6/2024,15:01,972.00,FALSE,436729.95,0,FALSE
518,3/7/2024,09:14,481.40,FALSE,437211.35,0,FALSE
519,3/7/2024,14:56,1153.70,FALSE,438365.05,5,FALSE
520,3/7/2024,11:32,605.90,FALSE,438970.95,5,FALSE
521,3/8/2024,14:47,532.80,FALSE,439503.75,4,FALSE
522,3/8/2024,16:15,481.40,FALSE,439985.15,4,FALSE
523,3/8/2024,15:50,617.40,FALSE,440602.55,3,FALSE
524,3/9/2024,11:17,1178.60,FALSE,441781.15,3,FALSE
525,3/9/2024,09:44,792.10,FALSE,442573.25,1,FALSE
526,3/9/2024,17:11,431.60,FALSE,443004.85,2,FALSE
527,3/10/2024,09:03,634.10,FALSE,443638.95,1,FALSE
528,3/10/2024,12:24,705.50,FALSE,444344.45,0,FALSE
529,3/10/2024,10:33,1062.40,FALSE,445406.85,4,FALSE
530,3/11/2024,15:20,572.70,FALSE,445979.55,5,FALSE
531,3/11/2024,17:06,514.60,FALSE,446494.15,4,FALSE
532,3/11/2024,12:17,639.10,FALSE,447133.25,4,FALSE
533,3/12/2024,11:34,655.00,FALSE,447788.25,1,FALSE
534,3/12/2024,11:55,1372.60,FALSE,449160.85,5,FALSE
535,3/12/2024,17:15,564.40,FALSE,449725.25,4,FALSE
536,3/13/2024,14:53,730.40,FALSE,450455.65,4,FALSE
537,3/13/2024,12:53,556.10,FALSE,451011.75,1,FALSE
538,3/13/2024,11:13,744.80,FALSE,451756.55,1,FALSE
539,3/14/2024,17:32,1386.10,FALSE,453142.65,3,FALSE
540,3/14/2024,14:58,664.00,FALSE,453806.65,3,FALSE
541,3/14/2024,10:54,558.60,FALSE,454365.25,4,FALSE
542,3/15/2024,17:46,784.00,FALSE,455149.25,3,FALSE
543,3/15/2024,10:02,639.10,FALSE,455788.35,2,FALSE
544,3/15/2024,17:12,1593.60,FALSE,457381.95,4,FALSE
545,3/16/2024,11:18,697.20,FALSE,458079.15,2,FALSE
546,3/16/2024,09:51,415.00,FALSE,458494.15,5,FALSE
547,3/16/2024,09:44,771.90,FALSE,459266.05,4,FALSE
548,3/17/2024,10:02,915.30,FALSE,460181.35,5,FALSE
549,3/17/2024,11:03,1263.10,FALSE,461444.45,5,FALSE
550,3/17/2024,12:42,821.70,FALSE,462266.15,3,FALSE
551,3/18/2024,16:23,755.30,FALSE,463021.45,0,FALSE
552,3/18/2024,11:50,755.30,FALSE,463776.75,4,FALSE
553,3/18/2024,12:50,780.60,FALSE,464557.35,1,FALSE
554,3/19/2024,13:14,949.20,FALSE,465506.55,1,FALSE
555,3/19/2024,11:36,691.20,FALSE,466197.75,5,FALSE
556,3/19/2024,16:21,770.30,FALSE,466968.05,2,FALSE
557,3/20/2024,10:32,376.20,FALSE,467344.25,3,FALSE
558,3/20/2024,17:18,1290.90,FALSE,468635.15,3,FALSE
559,3/20/2024,12:28,1908.00,FALSE,470543.15,1,FALSE
560,3/21/2024,10:57,1100.80,FALSE,471643.95,5,FALSE
561,3/21/2024,10:49,2308.00,FALSE,473951.95,0,FALSE
562,3/21/2024,11:30,621.50,FALSE,474573.45,2,FALSE
563,3/22/2024,09:18,1040.40,FALSE,475613.85,2,FALSE
564,3/22/2024,09:45,734.50,FALSE,476348.35,4,FALSE
565,3/22/2024,13:20,723.20,FALSE,477071.55,1,FALSE
566,3/23/2024,11:49,610.20,FALSE,477681.75,2,FALSE
567,3/23/2024,12:15,1241.60,FALSE,478923.35,2,FALSE
568,3/23/2024,16:58,892.70,FALSE,479816.05,1,FALSE
569,3/24/2024,17:32,892.70,FALSE,480708.75,5,FALSE
570,3/24/2024,09:32,786.50,FALSE,481495.25,1,FALSE
571,3/24/2024,12:03,621.50,FALSE,482116.75,0,FALSE
572,3/25/2024,15:01,695.50,FALSE,482812.25,1,FALSE
573,3/25/2024,17:39,1220.10,FALSE,484032.35,0,FALSE
574,3/25/2024,14:05,1073.80,FALSE,485106.15,4,FALSE
575,3/26/2024,13:40,707.00,FALSE,485813.15,4,FALSE
576,3/26/2024,14:08,827.10,FALSE,486640.25,1,FALSE
577,3/26/2024,12:56,734.50,FALSE,487374.75,4,FALSE
578,3/27/2024,16:53,792.30,FALSE,488167.05,3,FALSE
579,3/27/2024,17:31,1050.90,FALSE,489217.95,0,FALSE
580,3/27/2024,14:47,886.60,FALSE,490104.55,0,FALSE
581,3/28/2024,16:51,704.00,FALSE,490808.55,1,FALSE
582,3/28/2024,13:20,1005.70,FALSE,491814.25,4,FALSE
583,3/28/2024,14:40,1050.90,FALSE,492865.15,2,FALSE
584,3/29/2024,15:16,1084.80,FALSE,493949.95,0,FALSE
585,3/29/2024,16:00,1139.20,FALSE,495089.15,5,FALSE
586,3/29/2024,11:56,1005.70,FALSE,496094.85,5,FALSE
587,3/30/2024,13:32,757.10,FALSE,496851.95,4,FALSE
588,3/30/2024,16:33,872.20,FALSE,497724.15,5,FALSE
589,3/30/2024,12:49,723.20,FALSE,498447.35,5,FALSE
590,3/31/2024,15:47,793.80,FALSE,499241.15,5,FALSE
591,3/31/2024,10:04,686.00,FALSE,499927.15,1,FALSE
592,3/31/2024,09:35,872.20,FALSE,500799.35,4,FALSE
593,4/1/2024,09:03,568.40,FALSE,501367.75,1,FALSE
594,4/1/2024,11:53,793.80,FALSE,502161.55,3,FALSE
595,4/1/2024,17:57,734.50,FALSE,502896.05,1,FALSE
596,4/2/2024,17:16,1073.50,FALSE,503969.55,5,FALSE
597,4/2/2024,16:53,949.20,FALSE,504918.75,0,FALSE
598,4/2/2024,09:57,858.80,FALSE,505777.55,2,FALSE
599,4/3/2024,16:42,1039.60,FALSE,506817.15,1,FALSE
600,4/3/2024,12:25,568.40,FALSE,507385.55,4,FALSE
601,4/3/2024,16:17,970.20,FALSE,508355.75,4,FALSE
602,4/4/2024,12:03,901.60,FALSE,509257.35,1,FALSE
603,4/4/2024,16:09,882.00,FALSE,510139.35,0,FALSE
604,4/4/2024,12:56,904.00,FALSE,511043.35,0,FALSE
605,4/5/2024,15:44,1028.30,FALSE,512071.65,5,FALSE
606,4/5/2024,12:52,1062.20,FALSE,513133.85,3,FALSE
607,4/5/2024,15:08,1254.40,FALSE,514388.25,3,FALSE
608,4/6/2024,13:23,565.00,FALSE,514953.25,3,FALSE
609,4/6/2024,17:30,610.20,FALSE,515563.45,4,FALSE
610,4/6/2024,10:54,565.00,FALSE,516128.45,1,FALSE
611,4/7/2024,10:03,501.60,FALSE,516630.05,0,FALSE
612,4/7/2024,13:18,1314.20,FALSE,517944.25,0,FALSE
613,4/7/2024,17:23,1418.10,FALSE,519362.35,4,FALSE
614,4/8/2024,09:26,1201.20,FALSE,520563.55,5,FALSE
615,4/8/2024,13:22,1986.50,FALSE,522550.05,0,FALSE
616,4/8/2024,10:08,565.00,FALSE,523115.05,4,FALSE
617,4/9/2024,11:27,1871.10,FALSE,524986.15,0,FALSE
618,4/9/2024,15:40,1050.90,FALSE,526037.05,3,FALSE
619,4/9/2024,15:38,1039.60,FALSE,527076.65,0,FALSE
620,4/10/2024,15:33,576.30,FALSE,527652.95,3,FALSE
621,4/10/2024,15:01,802.30,FALSE,528455.25,3,FALSE
622,4/10/2024,14:07,565.00,FALSE,529020.25,2,FALSE
623,4/11/2024,16:52,565.00,FALSE,529585.25,3,FALSE
624,4/11/2024,09:58,915.30,FALSE,530500.55,3,FALSE
625,4/11/2024,13:34,1036.80,FALSE,531537.35,1,FALSE
626,4/12/2024,15:03,1052.90,FALSE,532590.25,4,FALSE
627,4/12/2024,10:44,947.30,FALSE,533537.55,3,FALSE
628,4/12/2024,09:37,891.70,FALSE,534429.25,4,FALSE
629,4/13/2024,15:08,1166.30,FALSE,535595.55,5,FALSE
630,4/13/2024,17:14,1288.60,FALSE,536884.15,2,FALSE
631,4/13/2024,16:06,836.20,FALSE,537720.35,2,FALSE
632,4/14/2024,10:28,1341.20,FALSE,539061.55,2,FALSE
633,4/14/2024,09:43,1177.60,FALSE,540239.15,5,FALSE
634,4/14/2024,16:09,1267.20,FALSE,541506.35,1,FALSE
635,4/15/2024,17:31,665.60,FALSE,542171.95,2,FALSE
636,4/15/2024,09:39,755.20,FALSE,542927.15,3,FALSE
637,4/15/2024,17:17,926.60,FALSE,543853.75,0,FALSE
638,4/16/2024,13:35,1228.80,FALSE,545082.55,1,FALSE
639,4/16/2024,14:22,915.30,FALSE,545997.85,1,FALSE
640,4/16/2024,17:31,1179.30,FALSE,547177.15,0,FALSE
641,4/17/2024,15:39,768.40,FALSE,547945.55,5,FALSE
642,4/17/2024,11:03,793.80,FALSE,548739.35,5,FALSE
643,4/17/2024,10:07,568.40,FALSE,549307.75,1,FALSE
644,4/18/2024,17:22,646.80,FALSE,549954.55,5,FALSE
645,4/18/2024,15:32,610.20,FALSE,550564.75,1,FALSE
646,4/18/2024,15:43,558.60,FALSE,551123.35,5,FALSE
647,4/19/2024,13:31,490.00,FALSE,551613.35,3,FALSE
648,4/19/2024,17:03,509.60,FALSE,552122.95,2,FALSE
649,4/19/2024,15:48,607.60,FALSE,552730.55,4,FALSE
650,4/20/2024,10:38,715.40,FALSE,553445.95,4,FALSE
651,4/20/2024,16:42,686.00,FALSE,554131.95,2,FALSE
652,4/20/2024,15:36,723.20,FALSE,554855.15,3,FALSE
653,4/21/2024,12:28,509.60,FALSE,555364.75,2,FALSE
654,4/21/2024,10:15,499.80,FALSE,555864.55,5,FALSE
655,4/21/2024,11:58,833.00,FALSE,556697.55,1,FALSE
656,4/22/2024,17:27,665.60,FALSE,557363.15,1,FALSE
657,4/22/2024,17:01,926.60,FALSE,558289.75,5,FALSE
658,4/22/2024,15:06,627.20,FALSE,558916.95,1,FALSE
659,4/23/2024,12:00,779.70,FALSE,559696.65,1,FALSE
660,4/23/2024,10:27,646.80,FALSE,560343.45,5,FALSE
661,4/23/2024,11:55,689.30,FALSE,561032.75,4,FALSE
662,4/24/2024,16:41,565.00,FALSE,561597.75,0,FALSE
663,4/24/2024,09:02,768.40,FALSE,562366.15,1,FALSE
664,4/24/2024,11:19,824.90,FALSE,563191.05,4,FALSE
665,4/25/2024,13:10,475.20,FALSE,563666.25,4,FALSE
666,4/25/2024,09:45,1401.00,FALSE,565067.25,3,FALSE
667,4/25/2024,09:53,1583.30,FALSE,566650.55,0,FALSE
668,4/26/2024,17:32,972.80,FALSE,567623.35,0,FALSE
669,4/26/2024,13:22,2308.80,FALSE,569932.15,0,FALSE
670,4/26/2024,13:21,960.00,FALSE,570892.15,2,FALSE
671,4/27/2024,11:30,1305.60,FALSE,572197.75,4,FALSE
672,4/27/2024,14:17,745.80,FALSE,572943.55,0,FALSE
673,4/27/2024,10:42,892.70,FALSE,573836.25,0,FALSE
674,4/28/2024,13:07,994.40,FALSE,574830.65,0,FALSE
675,4/28/2024,10:36,847.50,FALSE,575678.15,1,FALSE
676,4/28/2024,15:09,565.00,FALSE,576243.15,3,FALSE
677,4/29/2024,14:13,710.50,FALSE,576953.65,0,FALSE
678,4/29/2024,11:25,832.00,FALSE,577785.65,0,FALSE
679,4/29/2024,13:52,821.50,FALSE,578607.15,0,FALSE
680,4/30/2024,15:51,892.40,FALSE,579499.55,4,FALSE
681,4/30/2024,14:45,1024.70,FALSE,580524.25,3,FALSE
682,4/30/2024,17:49,1118.90,FALSE,581643.15,4,FALSE
683,5/1/2024,09:41,1066.90,FALSE,582710.05,4,FALSE
684,5/1/2024,16:46,1225.30,FALSE,583935.35,2,FALSE
685,5/1/2024,11:33,937.90,FALSE,584873.25,3,FALSE
686,5/2/2024,10:23,866.20,FALSE,585739.45,5,FALSE
687,5/2/2024,15:58,836.20,FALSE,586575.65,5,FALSE
688,5/2/2024,13:36,691.20,FALSE,587266.85,3,FALSE
689,5/3/2024,13:06,908.80,FALSE,588175.65,0,FALSE
690,5/3/2024,09:18,857.60,FALSE,589033.25,3,FALSE
691,5/3/2024,15:53,926.60,FALSE,589959.85,1,FALSE
692,5/4/2024,11:00,802.30,FALSE,590762.15,1,FALSE
693,5/4/2024,14:17,598.90,FALSE,591361.05,5,FALSE
694,5/4/2024,11:57,708.40,FALSE,592069.45,4,FALSE
695,5/5/2024,17:37,700.60,FALSE,592770.05,4,FALSE
696,5/5/2024,15:18,842.80,FALSE,593612.85,4,FALSE
697,5/5/2024,15:27,1286.50,FALSE,594899.35,3,FALSE
698,5/6/2024,15:27,747.00,FALSE,595646.35,2,FALSE
699,5/6/2024,10:21,862.40,FALSE,596508.75,5,FALSE
700,5/6/2024,15:43,456.50,FALSE,596965.25,0,FALSE
701,5/7/2024,16:20,705.50,FALSE,597670.75,0,FALSE
702,5/7/2024,10:43,1211.80,FALSE,598882.55,0,FALSE
703,5/7/2024,13:27,929.60,FALSE,599812.15,5,FALSE
704,5/8/2024,13:17,581.00,FALSE,600393.15,0,FALSE
705,5/8/2024,09:31,725.20,FALSE,601118.35,0,FALSE
706,5/8/2024,16:03,747.00,FALSE,601865.35,4,FALSE
707,5/9/2024,15:05,1253.30,FALSE,603118.65,5,FALSE
708,5/9/2024,17:11,423.30,FALSE,603541.95,0,FALSE
709,5/9/2024,09:40,672.30,FALSE,604214.25,1,FALSE
710,5/10/2024,16:57,522.90,FALSE,604737.15,3,FALSE
711,5/10/2024,13:27,522.90,FALSE,605260.05,2,FALSE
712,5/10/2024,09:51,1062.40,FALSE,606322.45,1,FALSE
713,5/11/2024,13:03,781.00,FALSE,607103.45,5,FALSE
714,5/11/2024,12:08,519.40,FALSE,607622.85,4,FALSE
715,5/11/2024,09:15,780.20,FALSE,608403.05,2,FALSE
716,5/12/2024,09:24,489.70,FALSE,608892.75,2,FALSE
717,5/12/2024,10:13,1685.50,FALSE,610578.25,2,FALSE
718,5/12/2024,16:00,899.40,FALSE,611477.65,3,FALSE
719,5/13/2024,17:29,564.40,FALSE,612042.05,4,FALSE
720,5/13/2024,12:01,456.50,FALSE,612498.55,3,FALSE
721,5/13/2024,15:36,568.40,FALSE,613066.95,2,FALSE
722,5/14/2024,16:52,1207.40,FALSE,614274.35,0,FALSE
723,5/14/2024,10:02,577.40,FALSE,614851.75,5,FALSE
724,5/14/2024,17:08,597.80,FALSE,615449.55,4,FALSE
725,5/15/2024,17:56,588.00,FALSE,616037.55,2,FALSE
726,5/15/2024,14:47,506.30,FALSE,616543.85,2,FALSE
727,5/15/2024,09:58,1211.80,FALSE,617755.65,1,FALSE
728,5/16/2024,16:06,473.10,FALSE,618228.75,4,FALSE
729,5/16/2024,12:00,622.50,FALSE,618851.25,2,FALSE
730,5/16/2024,10:44,776.50,FALSE,619627.75,2,FALSE
731,5/17/2024,16:04,858.80,FALSE,620486.55,1,FALSE
732,5/17/2024,15:43,1100.80,FALSE,621587.35,5,FALSE
733,5/17/2024,14:25,994.40,FALSE,622581.75,4,FALSE
734,5/18/2024,11:54,926.60,FALSE,623508.35,0,FALSE
735,5/18/2024,15:34,717.00,FALSE,624225.35,4,FALSE
736,5/18/2024,12:52,1366.80,FALSE,625592.15,3,FALSE
737,5/19/2024,15:36,1100.50,FALSE,626692.65,0,FALSE
738,5/19/2024,14:59,745.80,FALSE,627438.45,5,FALSE
739,5/19/2024,17:33,1456.00,FALSE,628894.45,1,FALSE
740,5/20/2024,14:31,587.60,FALSE,629482.05,3,FALSE
741,5/20/2024,14:16,1247.40,FALSE,630729.45,2,FALSE
742,5/20/2024,10:19,1005.70,FALSE,631735.15,5,FALSE
743,5/21/2024,16:21,587.60,FALSE,632322.75,0,FALSE
744,5/21/2024,11:19,921.60,FALSE,633244.35,5,FALSE
745,5/21/2024,14:38,896.00,FALSE,634140.35,4,FALSE
746,5/22/2024,15:05,576.30,FALSE,634716.65,5,FALSE
747,5/22/2024,09:33,576.30,FALSE,635292.95,0,FALSE
748,5/22/2024,13:57,937.90,FALSE,636230.85,0,FALSE
749,5/23/2024,16:42,937.90,FALSE,637168.75,0,FALSE
750,5/23/2024,13:03,1132.50,FALSE,638301.25,4,FALSE
751,5/23/2024,10:06,1011.10,FALSE,639312.35,4,FALSE
752,5/24/2024,17:19,1192.70,FALSE,640505.05,3,FALSE
753,5/24/2024,16:34,1112.10,FALSE,641617.15,4,FALSE
754,5/24/2024,09:52,1070.80,FALSE,642687.95,1,FALSE
755,5/25/2024,10:31,745.80,FALSE,643433.75,1,FALSE
756,5/25/2024,17:40,1283.40,FALSE,644717.15,3,FALSE
757,5/25/2024,13:01,700.60,FALSE,645417.75,1,FALSE
758,5/26/2024,16:49,1315.60,FALSE,646733.35,3,FALSE
759,5/26/2024,14:23,802.30,FALSE,647535.65,0,FALSE
760,5/26/2024,14:26,1017.00,FALSE,648552.65,3,FALSE
761,5/27/2024,13:09,1100.80,FALSE,649653.45,0,FALSE
762,5/27/2024,12:42,665.60,FALSE,650319.05,2,FALSE
763,5/27/2024,17:14,655.40,FALSE,650974.45,5,FALSE
764,5/28/2024,12:21,655.40,FALSE,651629.85,2,FALSE
765,5/28/2024,09:30,924.00,FALSE,652553.85,0,FALSE
766,5/28/2024,12:01,921.20,FALSE,653475.05,4,FALSE
767,5/29/2024,12:39,847.50,FALSE,654322.55,4,FALSE
768,5/29/2024,14:13,529.20,FALSE,654851.75,3,FALSE
769,5/29/2024,15:26,757.10,FALSE,655608.85,0,FALSE
770,5/30/2024,14:22,568.40,FALSE,656177.25,1,FALSE
771,5/30/2024,11:21,970.20,FALSE,657147.45,0,FALSE
772,5/30/2024,11:09,548.80,FALSE,657696.25,5,FALSE
773,5/31/2024,09:15,617.40,FALSE,658313.65,0,FALSE
774,5/31/2024,17:21,833.00,FALSE,659146.65,0,FALSE
775,5/31/2024,11:47,509.60,FALSE,659656.25,2,FALSE
776,6/1/2024,11:08,940.80,FALSE,660597.05,3,FALSE
777,6/1/2024,14:06,715.40,FALSE,661312.45,5,FALSE
778,6/1/2024,09:19,813.40,FALSE,662125.85,4,FALSE
779,6/2/2024,16:23,970.20,FALSE,663096.05,4,FALSE
780,6/2/2024,14:51,862.40,FALSE,663958.45,4,FALSE
781,6/2/2024,16:22,490.00,FALSE,664448.45,5,FALSE
782,6/3/2024,17:33,774.20,FALSE,665222.65,5,FALSE
783,6/3/2024,13:27,607.60,FALSE,665830.25,3,FALSE
784,6/3/2024,13:20,686.00,FALSE,666516.25,0,FALSE
785,6/4/2024,09:51,1118.70,FALSE,667634.95,3,FALSE
786,6/4/2024,17:44,689.30,FALSE,668324.25,3,FALSE
787,6/4/2024,17:54,598.90,FALSE,668923.15,5,FALSE
788,6/5/2024,17:58,711.90,FALSE,669635.05,3,FALSE
789,6/5/2024,10:15,541.20,FALSE,670176.25,0,FALSE
790,6/5/2024,17:42,1481.00,FALSE,671657.25,3,FALSE
791,6/6/2024,10:19,1645.20,FALSE,673302.45,5,FALSE
792,6/6/2024,15:50,847.50,FALSE,674149.95,0,FALSE
793,6/6/2024,09:40,1984.00,FALSE,676133.95,3,FALSE
794,6/7/2024,11:47,926.60,FALSE,677060.55,4,FALSE
795,6/7/2024,12:14,1266.30,FALSE,678326.85,4,FALSE
796,6/7/2024,17:47,844.80,FALSE,679171.65,4,FALSE
797,6/8/2024,12:20,768.40,FALSE,679940.05,0,FALSE
798,6/8/2024,14:51,689.30,FALSE,680629.35,3,FALSE
799,6/8/2024,12:12,1096.10,FALSE,681725.45,1,FALSE
800,6/9/2024,10:44,587.60,FALSE,682313.05,5,FALSE
801,6/9/2024,12:10,665.60,FALSE,682978.65,4,FALSE
802,6/9/2024,16:22,883.20,FALSE,683861.85,5,FALSE
803,6/10/2024,09:38,779.70,FALSE,684641.55,2,FALSE
804,6/10/2024,13:44,1111.00,FALSE,685752.55,3,FALSE
805,6/10/2024,17:04,1142.40,FALSE,686894.95,2,FALSE
806,6/11/2024,14:36,912.80,FALSE,687807.75,5,FALSE
807,6/11/2024,10:19,1090.40,FALSE,688898.15,5,FALSE
808,6/11/2024,13:44,799.70,FALSE,689697.85,4,FALSE
809,6/12/2024,17:23,576.30,FALSE,690274.15,2,FALSE
810,6/12/2024,17:39,1360.00,FALSE,691634.15,5,FALSE
811,6/12/2024,09:23,1228.80,FALSE,692862.95,3,FALSE
812,6/13/2024,13:49,857.60,FALSE,693720.55,2,FALSE
813,6/13/2024,13:04,813.60,FALSE,694534.15,4,FALSE
814,6/13/2024,15:13,915.30,FALSE,695449.45,3,FALSE
815,6/14/2024,15:28,1096.10,FALSE,696545.55,2,FALSE
816,6/14/2024,16:46,858.80,FALSE,697404.35,3,FALSE
817,6/14/2024,16:53,1039.60,FALSE,698443.95,4,FALSE
818,6/15/2024,17:32,1039.60,FALSE,699483.55,4,FALSE
819,6/15/2024,11:40,689.30,FALSE,700172.85,2,FALSE
820,6/15/2024,12:40,620.70,FALSE,700793.55,0,FALSE
821,6/16/2024,15:04,597.80,FALSE,701391.35,2,FALSE
822,6/16/2024,10:21,1017.00,FALSE,702408.35,4,FALSE
823,6/16/2024,10:52,656.60,FALSE,703064.95,0,FALSE
824,6/17/2024,12:44,852.60,FALSE,703917.55,5,FALSE
825,6/17/2024,12:37,823.20,FALSE,704740.75,5,FALSE
826,6/17/2024,16:00,695.80,FALSE,705436.55,3,FALSE
827,6/18/2024,16:12,666.40,FALSE,706102.95,0,FALSE
828,6/18/2024,16:53,1050.90,FALSE,707153.85,1,FALSE
829,6/18/2024,12:43,983.10,FALSE,708136.95,3,FALSE
830,6/19/2024,09:36,1118.70,FALSE,709255.65,3,FALSE
831,6/19/2024,13:51,950.60,FALSE,710206.25,0,FALSE
832,6/19/2024,15:49,637.00,FALSE,710843.25,5,FALSE
833,6/20/2024,16:26,803.60,FALSE,711646.85,0,FALSE
834,6/20/2024,11:30,539.00,FALSE,712185.85,0,FALSE
835,6/20/2024,13:41,1130.00,FALSE,713315.85,1,FALSE
836,6/21/2024,14:26,723.20,FALSE,714039.05,5,FALSE
837,6/21/2024,13:34,725.20,FALSE,714764.25,2,FALSE
838,6/21/2024,15:00,529.20,FALSE,715293.45,2,FALSE
839,6/22/2024,10:28,793.60,FALSE,716087.05,4,FALSE
840,6/22/2024,11:23,994.40,FALSE,717081.45,3,FALSE
841,6/22/2024,10:39,1075.20,FALSE,718156.65,2,FALSE
842,6/23/2024,13:15,666.70,FALSE,718823.35,4,FALSE
843,6/23/2024,14:44,481.80,FALSE,719305.15,1,FALSE
844,6/23/2024,13:17,1396.40,FALSE,720701.55,2,FALSE
845,6/24/2024,09:32,1171.00,FALSE,721872.55,0,FALSE
846,6/24/2024,11:34,715.00,FALSE,722587.55,5,FALSE
847,6/24/2024,16:07,2072.80,FALSE,724660.35,3,FALSE
848,6/25/2024,15:49,742.40,FALSE,725402.75,0,FALSE
849,6/25/2024,15:31,1182.60,FALSE,726585.35,5,FALSE
850,6/25/2024,15:56,610.20,FALSE,727195.55,1,FALSE
851,6/26/2024,09:51,847.50,FALSE,728043.05,5,FALSE
852,6/26/2024,14:45,1126.40,FALSE,729169.45,3,FALSE
853,6/26/2024,13:13,768.40,FALSE,729937.85,0,FALSE
854,6/27/2024,13:38,994.40,FALSE,730932.25,1,FALSE
855,6/27/2024,12:25,994.40,FALSE,731926.65,4,FALSE
856,6/27/2024,13:47,1265.70,FALSE,733192.35,5,FALSE
857,6/28/2024,14:21,1225.20,FALSE,734417.55,3,FALSE
858,6/28/2024,16:07,1045.30,FALSE,735462.85,2,FALSE
859,6/28/2024,17:33,1104.80,FALSE,736567.65,4,FALSE
860,6/29/2024,14:51,700.80,FALSE,737268.45,5,FALSE
861,6/29/2024,15:14,1140.40,FALSE,738408.85,4,FALSE
862,6/29/2024,13:09,682.10,FALSE,739090.95,0,FALSE
863,6/30/2024,09:04,711.90,FALSE,739802.85,0,FALSE
864,6/30/2024,11:32,1293.80,FALSE,741096.65,1,FALSE
865,6/30/2024,12:29,971.80,FALSE,742068.45,0,FALSE
866,7/1/2024,16:35,1139.20,FALSE,743207.65,2,FALSE
867,7/1/2024,10:44,832.00,FALSE,744039.65,4,FALSE
868,7/1/2024,12:05,892.70,FALSE,744932.35,3,FALSE
869,7/2/2024,13:47,921.60,FALSE,745853.95,1,FALSE
870,7/2/2024,11:27,779.70,FALSE,746633.65,2,FALSE
871,7/2/2024,12:30,1329.90,FALSE,747963.55,0,FALSE
872,7/3/2024,14:32,1286.40,FALSE,749249.95,4,FALSE
873,7/3/2024,12:31,1005.70,FALSE,750255.65,5,FALSE
874,7/3/2024,12:14,722.10,FALSE,750977.75,1,FALSE
875,7/4/2024,17:55,1460.80,FALSE,752438.55,2,FALSE
876,7/4/2024,11:13,612.70,FALSE,753051.25,1,FALSE
877,7/4/2024,17:07,581.00,FALSE,753632.25,4,FALSE
878,7/5/2024,12:07,605.90,FALSE,754238.15,1,FALSE
879,7/5/2024,10:12,725.20,FALSE,754963.35,2,FALSE
880,7/5/2024,10:19,1070.70,FALSE,756034.05,5,FALSE
881,7/6/2024,15:28,796.80,FALSE,756830.85,0,FALSE
882,7/6/2024,16:12,642.00,FALSE,757472.85,3,FALSE
883,7/6/2024,13:56,473.10,FALSE,757945.95,4,FALSE
884,7/7/2024,14:51,780.20,FALSE,758726.15,5,FALSE
885,7/7/2024,12:30,1054.10,FALSE,759780.25,4,FALSE
886,7/7/2024,16:58,506.30,FALSE,760286.55,4,FALSE
887,7/8/2024,09:35,531.20,FALSE,760817.75,0,FALSE
888,7/8/2024,12:28,509.60,FALSE,761327.35,1,FALSE
889,7/8/2024,14:51,980.00,FALSE,762307.35,4,FALSE
890,7/9/2024,16:24,1371.80,FALSE,763679.15,5,FALSE
891,7/9/2024,09:03,581.10,FALSE,764260.25,4,FALSE
892,7/9/2024,15:08,788.50,FALSE,765048.75,4,FALSE
893,7/10/2024,13:59,632.20,FALSE,765680.95,0,FALSE
894,7/10/2024,15:17,882.00,FALSE,766562.95,4,FALSE
895,7/10/2024,10:15,1328.00,FALSE,767890.95,5,FALSE
896,7/11/2024,16:59,713.80,FALSE,768604.75,0,FALSE
897,7/11/2024,16:34,768.10,FALSE,769372.85,2,FALSE
898,7/11/2024,15:51,680.60,FALSE,770053.45,0,FALSE
899,7/12/2024,09:58,627.20,FALSE,770680.65,3,FALSE
900,7/12/2024,17:46,1376.40,FALSE,772057.05,3,FALSE
901,7/12/2024,15:49,539.50,FALSE,772596.55,1,FALSE
902,7/13/2024,12:46,519.40,FALSE,773115.95,4,FALSE
903,7/13/2024,16:25,531.20,FALSE,773647.15,2,FALSE
904,7/13/2024,12:37,439.90,FALSE,774087.05,2,FALSE
905,7/14/2024,11:28,1137.10,FALSE,775224.15,2,FALSE
906,7/14/2024,15:13,796.80,FALSE,776020.95,5,FALSE
907,7/14/2024,13:46,639.10,FALSE,776660.05,4,FALSE
908,7/15/2024,16:01,506.30,FALSE,777166.35,3,FALSE
909,7/15/2024,13:41,921.60,FALSE,778087.95,0,FALSE
910,7/15/2024,13:54,853.80,FALSE,778941.75,4,FALSE
911,7/16/2024,17:29,779.70,FALSE,779721.45,1,FALSE
912,7/16/2024,17:57,1107.40,FALSE,780828.85,2,FALSE
913,7/16/2024,09:41,653.40,FALSE,781482.25,1,FALSE
914,7/17/2024,14:24,1719.30,FALSE,783201.55,3,FALSE
915,7/17/2024,09:53,1742.70,FALSE,784944.25,5,FALSE
916,7/17/2024,14:47,1062.20,FALSE,786006.45,1,FALSE
917,7/18/2024,14:49,2134.00,FALSE,788140.45,1,FALSE
918,7/18/2024,17:36,587.60,FALSE,788728.05,4,FALSE
919,7/18/2024,12:19,1115.10,FALSE,789843.15,5,FALSE
920,7/19/2024,11:54,836.20,FALSE,790679.35,5,FALSE
921,7/19/2024,14:15,847.50,FALSE,791526.85,5,FALSE
922,7/19/2024,13:22,1267.20,FALSE,792794.05,3,FALSE
923,7/20/2024,11:59,689.30,FALSE,793483.35,1,FALSE
924,7/20/2024,17:26,1187.60,FALSE,794670.95,0,FALSE
925,7/20/2024,14:41,1096.10,FALSE,795767.05,4,FALSE
926,7/21/2024,16:27,1017.00,FALSE,796784.05,5,FALSE
927,7/21/2024,09:50,1017.00,FALSE,797801.05,5,FALSE
928,7/21/2024,14:32,992.40,FALSE,798793.45,2,FALSE
929,7/22/2024,11:31,971.20,FALSE,799764.65,0,FALSE
930,7/22/2024,12:24,1282.50,FALSE,801047.15,5,FALSE
931,7/22/2024,17:52,1082.10,FALSE,802129.25,0,FALSE
932,7/23/2024,17:15,877.80,FALSE,803007.05,1,FALSE
933,7/23/2024,09:57,994.40,FALSE,804001.45,2,FALSE
934,7/23/2024,09:54,1080.70,FALSE,805082.15,4,FALSE
935,7/24/2024,13:14,1005.70,FALSE,806087.85,4,FALSE
936,7/24/2024,17:58,665.60,FALSE,806753.45,2,FALSE
937,7/24/2024,13:32,689.30,FALSE,807442.75,0,FALSE
938,7/25/2024,14:24,947.20,FALSE,808389.95,2,FALSE
939,7/25/2024,13:51,1280.00,FALSE,809669.95,0,FALSE
940,7/25/2024,09:48,1039.60,FALSE,810709.55,2,FALSE
941,7/26/2024,11:56,700.60,FALSE,811410.15,5,FALSE
942,7/26/2024,17:13,700.60,FALSE,812110.75,4,FALSE
943,7/26/2024,15:56,1050.90,FALSE,813161.65,4,FALSE
944,7/27/2024,10:40,676.20,FALSE,813837.85,3,FALSE
945,7/27/2024,09:08,509.60,FALSE,814347.45,3,FALSE
946,7/27/2024,16:03,607.60,FALSE,814955.05,0,FALSE
947,7/28/2024,16:43,617.40,FALSE,815572.45,1,FALSE
948,7/28/2024,09:22,744.80,FALSE,816317.25,5,FALSE
949,7/28/2024,17:28,587.60,FALSE,816904.85,3,FALSE
950,7/29/2024,14:47,548.80,FALSE,817453.65,2,FALSE
951,7/29/2024,11:25,904.00,FALSE,818357.65,0,FALSE
952,7/29/2024,15:54,901.60,FALSE,819259.25,3,FALSE
953,7/30/2024,16:42,646.80,FALSE,819906.05,2,FALSE
954,7/30/2024,12:56,509.60,FALSE,820415.65,1,FALSE
955,7/30/2024,12:34,870.10,FALSE,821285.75,0,FALSE
956,7/31/2024,09:08,656.60,FALSE,821942.35,2,FALSE
957,7/31/2024,14:03,813.40,FALSE,822755.75,4,FALSE
958,7/31/2024,13:31,499.80,FALSE,823255.55,2,FALSE
959,8/1/2024,13:48,689.30,FALSE,823944.85,2,FALSE
960,8/1/2024,13:31,892.70,FALSE,824837.55,5,FALSE
961,8/1/2024,09:40,779.70,FALSE,825617.25,4,FALSE
962,8/2/2024,09:47,676.20,FALSE,826293.45,3,FALSE
963,8/2/2024,15:31,565.00,FALSE,826858.45,4,FALSE
964,8/2/2024,17:07,1028.30,FALSE,827886.75,3,FALSE
965,8/3/2024,17:05,1029.20,FALSE,828915.95,0,FALSE
966,8/3/2024,16:21,655.40,FALSE,829571.35,4,FALSE
967,8/3/2024,14:39,575.40,FALSE,830146.75,1,FALSE
968,8/4/2024,12:58,1212.40,FALSE,831359.15,2,FALSE
969,8/4/2024,11:12,1491.50,FALSE,832850.65,2,FALSE
970,8/4/2024,11:42,1005.70,FALSE,833856.35,4,FALSE
971,8/5/2024,10:58,1954.40,FALSE,835810.75,3,FALSE
972,8/5/2024,12:54,1107.40,FALSE,836918.15,2,FALSE
973,8/5/2024,12:45,1203.60,FALSE,838121.75,1,FALSE
974,8/6/2024,12:36,1005.70,FALSE,839127.45,1,FALSE
975,8/6/2024,12:28,757.10,FALSE,839884.55,4,FALSE
976,8/6/2024,15:40,791.00,FALSE,840675.55,3,FALSE
977,8/7/2024,16:46,587.60,FALSE,841263.15,4,FALSE
978,8/7/2024,09:48,1130.00,FALSE,842393.15,1,FALSE
979,8/7/2024,10:55,1130.00,FALSE,843523.15,5,FALSE
980,8/8/2024,15:28,644.10,FALSE,844167.25,0,FALSE
981,8/8/2024,16:34,644.10,FALSE,844811.35,4,FALSE
982,8/8/2024,15:26,1004.50,FALSE,845815.85,0,FALSE
983,8/9/2024,09:06,898.10,FALSE,846713.95,2,FALSE
984,8/9/2024,13:19,1185.20,FALSE,847899.15,5,FALSE
985,8/9/2024,09:22,1030.10,FALSE,848929.25,5,FALSE
986,8/10/2024,13:43,869.70,FALSE,849798.95,5,FALSE
987,8/10/2024,17:42,678.00,FALSE,850476.95,1,FALSE
988,8/10/2024,12:55,813.60,FALSE,851290.55,2,FALSE
989,8/11/2024,17:24,632.80,FALSE,851923.35,0,FALSE
990,8/11/2024,15:04,1344.20,FALSE,853267.55,0,FALSE
991,8/11/2024,14:26,745.80,FALSE,854013.35,2,FALSE
992,8/12/2024,17:10,926.60,FALSE,854939.95,5,FALSE
993,8/12/2024,09:55,870.10,FALSE,855810.05,2,FALSE
994,8/12/2024,14:03,983.10,FALSE,856793.15,0,FALSE
995,8/13/2024,10:36,998.40,FALSE,857791.55,5,FALSE
996,8/13/2024,11:51,1004.40,FALSE,858795.95,3,FALSE
997,8/13/2024,12:20,1280.00,FALSE,860075.95,1,FALSE
998,8/14/2024,11:49,911.40,FALSE,860987.35,0,FALSE
999,8/14/2024,12:40,745.80,FALSE,861733.15,0,FALSE
1000,8/14/2024,16:38,960.40,FALSE,862693.55,4,FALSE
1001,8/15/2024,17:40,627.20,FALSE,863320.75,2,FALSE
1002,8/15/2024,12:21,519.40,FALSE,863840.15,2,FALSE
1003,8/15/2024,09:03,519.40,FALSE,864359.55,4,FALSE
1004,8/16/2024,15:32,883.20,FALSE,865242.75,0,FALSE
1005,8/16/2024,15:01,960.40,FALSE,866203.15,1,FALSE
1006,8/16/2024,15:09,858.80,FALSE,867061.95,0,FALSE
1007,8/17/2024,16:47,1130.00,FALSE,868191.95,4,FALSE
1008,8/17/2024,11:13,911.40,FALSE,869103.35,4,FALSE
1009,8/17/2024,12:46,980.00,FALSE,870083.35,1,FALSE
1010,8/18/2024,15:31,588.00,FALSE,870671.35,4,FALSE
1011,8/18/2024,15:32,588.00,FALSE,871259.35,3,FALSE
1012,8/18/2024,13:14,678.00,FALSE,871937.35,2,FALSE
1013,8/19/2024,12:58,1017.00,FALSE,872954.35,4,FALSE
1014,8/19/2024,14:50,607.60,FALSE,873561.95,2,FALSE
1015,8/19/2024,15:58,774.20,FALSE,874336.15,4,FALSE
1016,8/20/2024,09:41,872.20,FALSE,875208.35,0,FALSE
1017,8/20/2024,15:47,1130.00,FALSE,876338.35,3,FALSE
1018,8/20/2024,10:39,1223.50,FALSE,877561.85,0,FALSE
1019,8/21/2024,13:48,1017.00,FALSE,878578.85,0,FALSE
1020,8/21/2024,10:34,587.60,FALSE,879166.45,4,FALSE
1021,8/21/2024,13:22,567.60,FALSE,879734.05,4,FALSE
1022,8/22/2024,13:33,1681.60,FALSE,881415.65,3,FALSE
1023,8/22/2024,10:18,1666.00,FALSE,883081.65,2,FALSE
1024,8/22/2024,09:39,908.80,FALSE,883990.45,1,FALSE
1025,8/23/2024,11:09,2373.20,FALSE,886363.65,4,FALSE
1026,8/23/2024,10:43,768.40,FALSE,887132.05,3,FALSE
1027,8/23/2024,10:16,2019.60,FALSE,889151.65,2,FALSE
1028,8/24/2024,16:14,858.80,FALSE,890010.45,2,FALSE
1029,8/24/2024,12:59,723.20,FALSE,890733.65,5,FALSE
1030,8/24/2024,14:16,644.10,FALSE,891377.75,1,FALSE
1031,8/25/2024,13:45,1190.40,FALSE,892568.15,2,FALSE
1032,8/25/2024,09:09,1265.90,FALSE,893834.05,2,FALSE
1033,8/25/2024,13:09,1126.40,FALSE,894960.45,5,FALSE
1034,8/26/2024,11:28,689.70,FALSE,895650.15,5,FALSE
1035,8/26/2024,10:11,610.20,FALSE,896260.35,0,FALSE
1036,8/26/2024,10:50,1211.60,FALSE,897471.95,1,FALSE
1037,8/27/2024,09:28,964.60,FALSE,898436.55,5,FALSE
1038,8/27/2024,10:56,858.90,FALSE,899295.45,2,FALSE
1039,8/27/2024,17:20,1248.40,FALSE,900543.85,0,FALSE
1040,8/28/2024,14:01,1165.70,FALSE,901709.55,4,FALSE
1041,8/28/2024,14:06,779.70,FALSE,902489.25,4,FALSE
1042,8/28/2024,17:33,1235.20,FALSE,903724.45,3,FALSE
1043,8/29/2024,11:08,723.20,FALSE,904447.65,0,FALSE
1044,8/29/2024,15:48,1144.00,FALSE,905591.65,0,FALSE
1045,8/29/2024,11:12,1028.30,FALSE,906619.95,3,FALSE
1046,8/30/2024,15:49,755.20,FALSE,907375.15,5,FALSE
1047,8/30/2024,14:08,1005.70,FALSE,908380.85,0,FALSE
1048,8/30/2024,15:57,847.50,FALSE,909228.35,2,FALSE
1049,8/31/2024,16:21,1118.70,FALSE,910347.05,2,FALSE
1050,8/31/2024,09:50,1118.70,FALSE,911465.75,0,FALSE
1051,8/31/2024,09:10,994.40,FALSE,912460.15,0,FALSE
1052,9/1/2024,13:10,622.50,FALSE,913082.65,2,FALSE
1053,9/1/2024,14:08,1411.00,FALSE,914493.65,0,FALSE
1054,9/1/2024,14:06,597.60,FALSE,915091.25,5,FALSE
1055,9/2/2024,10:25,784.20,FALSE,915875.45,5,FALSE
1056,9/2/2024,17:34,439.90,FALSE,916315.35,5,FALSE
1057,9/2/2024,09:46,666.40,FALSE,916981.75,0,FALSE
1058,9/3/2024,16:21,1128.80,FALSE,918110.55,5,FALSE
1059,9/3/2024,14:25,621.20,FALSE,918731.75,4,FALSE
1060,9/3/2024,10:04,548.80,FALSE,919280.55,0,FALSE
1061,9/4/2024,15:37,755.30,FALSE,920035.85,2,FALSE
1062,9/4/2024,09:55,639.10,FALSE,920674.95,3,FALSE
1063,9/4/2024,12:04,1263.30,FALSE,921938.25,1,FALSE
1064,9/5/2024,12:00,464.80,FALSE,922403.05,1,FALSE
1065,9/5/2024,10:43,666.40,FALSE,923069.45,5,FALSE
1066,9/5/2024,10:08,647.40,FALSE,923716.85,0,FALSE
1067,9/6/2024,12:55,688.90,FALSE,924405.75,5,FALSE
1068,9/6/2024,12:07,1294.80,FALSE,925700.55,5,FALSE
1069,9/6/2024,11:01,955.90,FALSE,926656.45,2,FALSE
1070,9/7/2024,13:50,918.30,FALSE,927574.75,4,FALSE
1071,9/7/2024,13:50,980.00,FALSE,928554.75,1,FALSE
1072,9/7/2024,15:43,431.60,FALSE,928986.35,3,FALSE
1073,9/8/2024,10:09,1305.50,FALSE,930291.85,1,FALSE
1074,9/8/2024,17:17,647.40,FALSE,930939.25,0,FALSE
1075,9/8/2024,11:19,673.10,FALSE,931612.35,1,FALSE
1076,9/9/2024,14:52,481.40,FALSE,932093.75,1,FALSE
1077,9/9/2024,11:44,643.10,FALSE,932736.85,2,FALSE
1078,9/9/2024,13:59,1095.90,FALSE,933832.75,3,FALSE
1079,9/10/2024,12:42,771.90,FALSE,934604.65,4,FALSE
1080,9/10/2024,12:35,830.00,FALSE,935434.65,1,FALSE
1081,9/10/2024,15:10,199.20,FALSE,935633.85,1,FALSE
1082,9/11/2024,09:37,983.10,FALSE,936616.95,1,FALSE
1083,9/11/2024,15:19,1402.70,FALSE,938019.65,3,FALSE
1084,9/11/2024,16:20,464.80,FALSE,938484.45,5,FALSE
1085,9/12/2024,16:42,695.80,FALSE,939180.25,1,FALSE
1086,9/12/2024,11:19,780.20,FALSE,939960.45,0,FALSE
1087,9/12/2024,13:50,896.30,FALSE,940856.75,3,FALSE
1088,9/13/2024,11:31,136.50,FALSE,940993.25,2,FALSE
1089,9/13/2024,17:43,833.00,FALSE,941826.25,1,FALSE
1090,9/13/2024,15:04,506.30,FALSE,942332.55,3,FALSE
1091,9/14/2024,11:11,621.50,FALSE,942954.05,1,FALSE
1092,9/14/2024,11:05,672.30,FALSE,943626.35,1,FALSE
1093,9/14/2024,16:30,738.70,FALSE,944365.05,5,FALSE
1094,9/15/2024,11:56,780.20,FALSE,945145.25,0,FALSE
1095,9/15/2024,10:01,597.60,FALSE,945742.85,4,FALSE
1096,9/15/2024,17:02,589.30,FALSE,946332.15,2,FALSE
1097,9/16/2024,16:04,423.30,FALSE,946755.45,0,FALSE
1098,9/16/2024,15:35,639.10,FALSE,947394.55,2,FALSE
1099,9/16/2024,12:53,803.60,FALSE,948198.15,1,FALSE
1100,9/17/2024,09:17,672.30,FALSE,948870.45,3,FALSE
1101,9/17/2024,12:09,529.20,FALSE,949399.65,2,FALSE
1102,9/17/2024,16:27,904.00,FALSE,950303.65,3,FALSE
1103,9/18/2024,15:48,744.80,FALSE,951048.45,1,FALSE
1104,9/18/2024,11:37,911.40,FALSE,951959.85,0,FALSE
1105,9/18/2024,17:51,529.20,FALSE,952489.05,1,FALSE
1106,9/19/2024,15:52,499.80,FALSE,952988.85,0,FALSE
1107,9/19/2024,14:16,994.40,FALSE,953983.25,0,FALSE
1108,9/19/2024,09:56,1130.00,FALSE,955113.25,0,FALSE
1109,9/20/2024,14:34,842.80,FALSE,955956.05,1,FALSE
1110,9/20/2024,12:20,784.00,FALSE,956740.05,4,FALSE
1111,9/20/2024,15:22,1039.60,FALSE,957779.65,5,FALSE
1112,9/21/2024,14:58,872.20,FALSE,958651.85,2,FALSE
1113,9/21/2024,10:08,617.40,FALSE,959269.25,0,FALSE
1114,9/21/2024,10:56,901.60,FALSE,960170.85,5,FALSE
1115,9/22/2024,12:40,744.80,FALSE,960915.65,1,FALSE
1116,9/22/2024,11:57,872.20,FALSE,961787.85,0,FALSE
1117,9/22/2024,11:25,607.60,FALSE,962395.45,4,FALSE
1118,9/23/2024,13:25,644.10,FALSE,963039.55,2,FALSE
1119,9/23/2024,09:13,610.20,FALSE,963649.75,5,FALSE
1120,9/23/2024,17:04,1199.70,FALSE,964849.45,0,FALSE
1121,9/24/2024,10:23,1142.90,FALSE,965992.35,1,FALSE
1122,9/24/2024,14:36,396.00,FALSE,966388.35,1,FALSE
1123,9/24/2024,10:47,1047.60,FALSE,967435.95,1,FALSE
1124,9/25/2024,15:06,1043.20,FALSE,968479.15,5,FALSE
1125,9/25/2024,16:15,610.20,FALSE,969089.35,4,FALSE
1126,9/25/2024,12:51,2055.10,FALSE,971144.45,2,FALSE
1127,9/26/2024,14:06,819.20,FALSE,971963.65,2,FALSE
1128,9/26/2024,16:58,1757.70,FALSE,973721.35,3,FALSE
1129,9/26/2024,16:49,1201.20,FALSE,974922.55,5,FALSE
1130,9/27/2024,16:36,1017.00,FALSE,975939.55,1,FALSE
1131,9/27/2024,14:34,1126.40,FALSE,977065.95,0,FALSE
1132,9/27/2024,17:41,768.40,FALSE,977834.35,1,FALSE
1133,9/28/2024,10:36,813.60,FALSE,978647.95,5,FALSE
1134,9/28/2024,15:26,921.60,FALSE,979569.55,0,FALSE
1135,9/28/2024,16:23,755.20,FALSE,980324.75,1,FALSE
1136,9/29/2024,13:46,666.70,FALSE,980991.45,0,FALSE
1137,9/29/2024,12:45,1268.00,FALSE,982259.45,5,FALSE
1138,9/29/2024,17:21,1311.10,FALSE,983570.55,4,FALSE
1139,9/30/2024,10:40,1257.70,FALSE,984828.25,5,FALSE
1140,9/30/2024,12:32,1038.20,FALSE,985866.45,4,FALSE
1141,9/30/2024,15:54,1238.60,FALSE,987105.05,3,FALSE
1142,10/1/2024,11:02,1216.00,FALSE,988321.05,4,FALSE
1143,10/1/2024,17:22,782.50,FALSE,989103.55,5,FALSE
1144,10/1/2024,14:51,1073.50,FALSE,990177.05,2,FALSE
1145,10/2/2024,10:13,872.30,FALSE,991049.35,1,FALSE
1146,10/2/2024,11:57,632.80,FALSE,991682.15,2,FALSE
1147,10/2/2024,17:34,1039.60,FALSE,992721.75,2,FALSE
1148,10/3/2024,11:00,745.80,FALSE,993467.55,4,FALSE
1149,10/3/2024,10:58,983.10,FALSE,994450.65,5,FALSE
1150,10/3/2024,14:36,666.70,FALSE,995117.35,1,FALSE
1151,10/4/2024,12:59,666.70,FALSE,995784.05,3,FALSE
1152,10/4/2024,11:47,644.10,FALSE,996428.15,0,FALSE
1153,10/4/2024,12:12,774.20,FALSE,997202.35,5,FALSE
1154,10/5/2024,14:19,1224.70,FALSE,998427.05,1,FALSE
1155,10/5/2024,09:26,719.30,FALSE,999146.35,3,FALSE
1156,10/5/2024,10:26,581.00,FALSE,999727.35,3,FALSE
1157,10/6/2024,17:44,589.30,FALSE,1000316.65,2,FALSE
1158,10/6/2024,11:42,423.30,FALSE,1000739.95,0,FALSE
1159,10/6/2024,14:50,1293.40,FALSE,1002033.35,5,FALSE
1160,10/7/2024,11:08,597.70,FALSE,1002631.05,2,FALSE
1161,10/7/2024,09:52,788.50,FALSE,1003419.55,3,FALSE
1162,10/7/2024,15:23,456.50,FALSE,1003876.05,4,FALSE
1163,10/8/2024,09:25,696.70,FALSE,1004572.75,3,FALSE
1164,10/8/2024,11:53,1196.50,FALSE,1005769.25,3,FALSE
1165,10/8/2024,12:27,680.70,FALSE,1006449.95,4,FALSE
1166,10/9/2024,11:56,800.70,FALSE,1007250.65,3,FALSE
1167,10/9/2024,13:30,831.50,FALSE,1008082.15,3,FALSE
1168,10/9/2024,12:10,705.50,FALSE,1008787.65,3,FALSE
1169,10/10/2024,15:43,1336.30,FALSE,1010123.95,1,FALSE
1170,10/10/2024,15:49,929.70,FALSE,1011053.65,2,FALSE
1171,10/10/2024,11:50,664.00,FALSE,1011717.65,2,FALSE
1172,10/11/2024,16:44,547.80,FALSE,1012265.45,0,FALSE
1173,10/11/2024,16:17,805.10,FALSE,1013070.55,0,FALSE
1174,10/11/2024,17:31,1261.60,FALSE,1014332.15,4,FALSE
1175,10/12/2024,13:37,708.50,FALSE,1015040.65,0,FALSE
1176,10/12/2024,14:20,569.80,FALSE,1015610.45,2,FALSE
1177,10/12/2024,09:57,855.90,FALSE,1016466.35,5,FALSE
1178,10/13/2024,13:51,845.10,FALSE,1017311.45,1,FALSE
1179,10/13/2024,16:24,979.40,FALSE,1018290.85,2,FALSE
1180,10/13/2024,14:36,464.80,FALSE,1018755.65,0,FALSE
1181,10/14/2024,09:18,705.50,FALSE,1019461.15,3,FALSE
1182,10/14/2024,14:40,232.40,FALSE,1019693.55,5,FALSE
1183,10/14/2024,10:24,606.40,FALSE,1020299.95,1,FALSE
1184,10/15/2024,13:44,1236.70,FALSE,1021536.65,5,FALSE
1185,10/15/2024,13:04,489.70,FALSE,1022026.35,5,FALSE
1186,10/15/2024,11:43,735.90,FALSE,1022762.25,2,FALSE
1187,10/16/2024,09:38,821.70,FALSE,1023583.95,0,FALSE
1188,10/16/2024,12:40,821.70,FALSE,1024405.65,5,FALSE
1189,10/16/2024,17:12,0.00,FALSE,1024405.65,0,FALSE
1190,10/17/2024,16:09,572.70,FALSE,1024978.35,4,FALSE
1191,10/17/2024,14:09,921.20,FALSE,1025899.55,5,FALSE
1192,10/17/2024,13:22,1118.70,FALSE,1027018.25,4,FALSE
1193,10/18/2024,13:10,614.20,FALSE,1027632.45,1,FALSE
1194,10/18/2024,16:24,614.20,FALSE,1028246.65,2,FALSE
1195,10/18/2024,10:10,499.80,FALSE,1028746.45,4,FALSE
1196,10/19/2024,15:10,788.50,FALSE,1029534.95,1,FALSE
1197,10/19/2024,10:09,788.50,FALSE,1030323.45,2,FALSE
1198,10/19/2024,14:26,548.80,FALSE,1030872.25,1,FALSE
1199,10/20/2024,15:10,1005.70,FALSE,1031877.95,2,FALSE
1200,10/20/2024,10:20,581.00,FALSE,1032458.95,3,FALSE